0 0 0 0 0 0 0 0 0 0 0 0 0 0 0 0 0 0 0 0 0 0 0 0 0 0 0 0 0 0
0 + - - + - - - - - - - - - + - - - - + - - - - - - - - + 0
0 | 0 0 | 0 0 0 0 0 0 0 0 0 | 0 0 0 0 | 0 0 0 0 0 0 0 0 | 0
0 X 0 + + - + 0 + - - - + 0 | 0 0 + - + - + 0 0 0 0 0 0 | 0
0 | 0 | 0 0 | 0 | 0 0 0 | 0 | 0 0 | 0 0 0 | 0 0 0 0 0 0 | 0
0 X 0 + - - + 0 + - - - + - + - - + - - - + 0 0 0 0 0 0 | 0
0 | 0 | 0 0 0 0 0 0 0 0 0 0 0 0 0 0 0 0 0 | 0 0 0 0 0 0 | 0
0 + - + - - X - + 0 0 + - - + - - - + 0 0 G - - - - - - + 0
0 | 0 0 0 0 0 0 | 0 0 | 0 0 | 0 0 0 | 0 0 | 0 0 0 0 0 0 | 0
0 | 0 0 0 0 0 0 | 0 0 | 0 0 | 0 0 0 | 0 0 | 0 0 0 0 0 0 | 0
0 + - - X - + - + - - + - - + - - - + - - + 0 + - - - - + 0
0 | 0 0 0 0 | 0 | 0 0 0 0 0 | 0 0 0 0 0 0 | 0 | 0 0 0 0 | 0
0 | 0 0 0 0 | 0 | 0 0 0 0 0 | 0 0 0 0 0 0 | 0 | 0 0 0 0 | 0
0 | 0 0 0 0 | 0 | 0 0 + - - + - - - + 0 0 | 0 | 0 0 0 0 | 0
0 + - - - - + 0 + - - + 0 0 0 0 0 0 + - - + 0 + - - - - + 0
0 | 0 0 0 0 0 0 0 0 0 | 0 0 0 0 0 0 | 0 0 0 0 0 0 0 0 0 | 0
0 + - - - - + 0 0 0 0 | 0 0 0 0 0 0 | 0 0 0 0 + - - - - + 0
0 | 0 0 0 0 | 0 + 0 0 + - - - X - - + - + 0 0 | 0 0 0 0 0 0
0 | 0 0 0 0 | 0 | 0 0 0 0 0 0 0 0 0 0 0 | 0 0 | 0 0 0 0 0 0
0 | 0 0 0 0 | 0 | 0 0 0 0 0 0 0 0 0 0 0 | 0 0 | 0 0 0 0 0 0
0 + - - - - + - + - - - - - X - - - - - + - - + - - - - G 0
0 0 0 0 0 0 0 0 0 0 0 0 0 0 0 0 0 0 0 0 0 0 0 0 0 0 0 0 0 0