0 0 0 0 0 0 0 0 0 0 0 0 0 0 0 0 0 0 0 0 0 0 0 0 0 0 0 0
0 0 0 0 0 0 0 0 0 0 0 0 0 0 0 0 0 0 0 0 0 0 0 0 0 0 0 0
0 0 0 0 0 0 0 0 0 0 0 0 0 0 0 0 0 0 0 0 0 0 0 0 0 0 0 0
A B B B B B B B B B B B B F G B B B B B B B B B B B B C
J 0 0 0 0 0 0 0 0 0 0 0 0 j k 0 0 0 0 0 0 0 0 0 0 0 0 K
J 0 U V V W 0 U V V V W 0 j k 0 U V V V W 0 U V V W 0 K
J 0 j 0 0 k 0 j 0 0 0 k 0 j k 0 j 0 0 0 k 0 j 0 0 k 0 K
J 0 e f f g 0 e f f f g 0 e g 0 e f f f g 0 e f f g 0 K
J 0 0 0 0 0 0 0 0 0 0 0 0 0 0 0 0 0 0 0 0 0 0 0 0 0 0 K
J 0 U V V W 0 U W 0 U V V V V V V W 0 U W 0 U V V W 0 K
J 0 e f f g 0 j k 0 e f f Y X f f g 0 j k 0 e f f g 0 K
J 0 0 0 0 0 0 j k 0 0 0 0 j k 0 0 0 0 j k 0 0 0 0 0 0 K
R S S S S E 0 j h V V W 0 j k 0 U V V i k 0 D S S S S T
0 0 0 0 0 J 0 j X f f g 0 e g 0 e f f Y k 0 K 0 0 0 0 0
0 0 0 0 0 J 0 j k 0 0 0 0 0 0 0 0 0 0 j k 0 K 0 0 0 0 0
0 0 0 0 0 J 0 j k 0 b c c c c c c d 0 j k 0 K 0 0 0 0 0
B B B B B M 0 e g 0 l 0 0 0 0 0 0 m 0 e g 0 L B B B B B
0 0 0 0 0 0 0 0 0 0 l 0 0 0 0 0 0 m 0 0 0 0 0 0 0 0 0 0
S S S S S E 0 U W 0 l 0 0 0 0 0 0 m 0 U W 0 D S S S S S
0 0 0 0 0 J 0 j k 0 q r r r r r r s 0 j k 0 K 0 0 0 0 0
0 0 0 0 0 J 0 j k 0 0 0 0 0 0 0 0 0 0 j k 0 K 0 0 0 0 0
0 0 0 0 0 J 0 j k 0 U V V V V V V W 0 j k 0 K 0 0 0 0 0
A B B B B M 0 e g 0 e f f Y X f f g 0 e g 0 L B B B B C
J 0 0 0 0 0 0 0 0 0 0 0 0 j k 0 0 0 0 0 0 0 0 0 0 0 0 K
J 0 U V V W 0 U V V V W 0 j k 0 U V V V W 0 U V V W 0 K
J 0 e f Y k 0 e f f f g 0 e g 0 e f f f g 0 j X f g 0 K
J 0 0 0 j k 0 0 0 0 0 0 0 0 0 0 0 0 0 0 0 0 j k 0 0 0 K
P V W 0 j k 0 U W 0 U V V V V V V W 0 U W 0 j k 0 U V Q
H f g 0 e g 0 j k 0 e f f Y X f f g 0 j k 0 e g 0 e f I
J 0 0 0 0 0 0 j k 0 0 0 0 j k 0 0 0 0 j k 0 0 0 0 0 0 K
J 0 U V V V V i h V V W 0 j k 0 U V V i h V V V V W 0 K
J 0 e f f f f f f f f g 0 e g 0 e f f f f f f f f g 0 K
J 0 0 0 0 0 0 0 0 0 0 0 0 0 0 0 0 0 0 0 0 0 0 0 0 0 0 K
R S S S S S S S S S S S S S S S S S S S S S S S S S S T
0 0 0 0 0 0 0 0 0 0 0 0 0 0 0 0 0 0 0 0 0 0 0 0 0 0 0 0
0 0 0 0 0 0 0 0 0 0 0 0 0 0 0 0 0 0 0 0 0 0 0 0 0 0 0 0